11111111111111111111
13030303030303030301
10303030303030303031
10000000000000000001
10000000000000000001
10000000000000000001
10000000000000000001
11111111111111111111
1000000000000000000100001111111111111111
1000000000000000000100001D000000000000L1
1000000000000000000100001000000000000001
1000000000000000000100001000000000000001
1000000000000000000100001000000000000001
1000000000000000000111111000000000000001
1000000000000000000000000000000000000001
1000000000000000000000000000000000000001
1000000000000000000000000000000000000001
1000000000000000000111111000000000000001
1000000000000000000100001000000000000001
2222222000222222222200001000000000000001
2000002000200000000200001000000000000001
2000002000202222220200001UR0000000000001
2000000000202000020200001111111111111111
22222220002000000202
20000000002222222202
20000000000000000002
22222222222222222202
20000000000000000002
20222222222222222222
10000000000000000001
10000000000000000001
10000000000000000001
10000000000000000001
10000000000000000001
10000000000000000001
1000000000000000000100000000000002222222222333
1000020000000000000100000000000002000000002333
1000002000000000000100000000000002000000002333
1022222200000000000100000000000002000000002333
1000002000000000000100000000000002000000002333
1000020000000000000100000000000002000000002333
1000000000000000000100000000000002000000002333
1000000000000000000100000000000002000000002333
1000000000000000000100000000000002000000002333
1000000000000000000100000000000002222222222333
10000000000000000001
10000000000000000001
10000000100100000001
10000001000010000001
10000001000010000001
10000001000010000001
11111111000011111111
10000000000000000001
1000000000000001111210000000000000000000000000000111111
1111100001111000001213000000000000000000000000000100001
1000000000000001111213300000000000000000000000000100001
1000011110000000001213330000000000000000000000000100001
1202020202020202021213330000000000000000000000000100001
1000000000000000001213300000000000000000000000000100001
1020202020202020201213000000000000000000000000000100001
1000000000000000001210000000000000000000000000000111111
12020202020202020201
10000000000000000001
10202020202020202021
10000000000000000001
12020202020202020201
10000000000000000001
10202020202020202021
10000000000000000001
10202020202020202021
10000000000000000001
12020202020202020201
10000000000000000001
10202020202020202021
11000000000000000001
10100000000000000001
10010000000000000001
10001000000000000001
10000100000000000001
10000010000000000001
10000001000000000001
10000000100000000001
10000000000000000001
10000000000000000001
10000000000000000001
10000000000010000001
10000000000001000001
10000000000000100001
10000000000000010001
10000000000000001001
10000000000000000101
10000000000000000011
10000000000000000001
10000000000000000001
10000000000000000001
10000000000000000001
10000000000000000001
10000000000000000001
1R0000000000000000L1
1R0000000000000000L1
1R0000000UU0000000L1
1R000000L40R000000L1
1R0000000DD0000000L1
1R0000000000000000L1
1R0000000000000000L1
1R0000000000000000L1
10000000000000000001
10000000000000000001
11111111000011111111
1RRR000000000000LLL100000000000000000000000000000000000000111111111111111
1RRR000000000003LLL1000000000000000000000000000000000000001DDDDDDDDDDDDD1
1RRR000000000000LLL1000000000000000000000000000000000000001RDDDDDDDDDDDL1
1RRR000000000000LLL1000000000000000000000000000000000000001RR000000000LL1
1RRR000000000000LLL1000000000000000000000000000000000000001RR000000000LL1
1RRR000000000000LLL1000000000000000000000000000000000000001RR000000000LL1
1RRR000000000000LLL1000000000000000000000000000000000000001RR000000000LL1
1RRR000000000000LLL1000000000000000000000000000000000000001RR000000000LL1
1RRR000000000000LLL1000000000000000000000000000000000000001RR000000000LL1
1RRR000000000000LLL1000000000000000000000000000000000000001RR000000000LL1
1RRR000000000000LLL1000000000000000000000000000000000000001RR000000000LL1
1RRR000000000000LLL1000000000000000000000000000000000000001RR000000000LL1
1RRR000000000000LLL1000000000000000000000000000000000000001RR000000000LL1
1RRR000000000000LLL1000000000000000000000000000000000000001RR000000000LL1
1RRR000000000000LLL1000000000000000000000000000000000000001RUUUUUUUUUUUL1
1RRR000000000000LLL1000000000000000000000000000000000000001UUUUUUUUUUUUU1
1RRR000000000000LLL100000000000000000000000000000000000000111111111111111
11111111000011111111
10000000000000000001
10000000000000000001
10000000000000000001
10000000000000000001
10000000000000000001
10000000000000000001
10000000000000000001
10000000000000000001
10000000000000000001
12222222222222222201
10000000000000000001
10222222222222222221
10200000002000000001
10200000202022222201
10222222202000000201
10000000002222222201
10020000000000000001
10000000000000000001
10000000000000200001
10000000220000000001
10000000220020000001
10002000000000000001
10000000000000000001
10000000000002000001
22222202222222000001
10000222000002222001
10000000000000000001
12200002222222222221
1RRRR00LLLL200020001
10000000000202222201
10000000000000020001
11111111000011111111
12222200000000022221
1222R0000000000L2221
122RR0000000000LL221
12RRR0000000000LLL21
1RRRR0000000000LLLL1
1RRRR0000000000LLLL1
1RRRR0000000000LLLL1
1RRRR0000000000LLLL1
1RRRR0000000000LLLL1
1RRRR0000000000LLLL1
1RRRR0000000000LLLL1
1RRRR0000000000LLLL1
1RRRR0000000000LLLL1
12RRR0000000000LLL21
122RR0000000000LL221
1222R0000000000L2221
12222000000000022221
11111111000011111111
10000000000000000001
10030000000000030001
10000000000000000001
10000000000000000001
10000000000000000001
10000000000000000001
10000000000000000001
10000000000000000001
10000000000000000001
10000000000000000001
10000000000000000001
10000000000000000001
10000000000000000001
10000000000000000001
10000000000000000001
10000000000000000001
13303330000003330331
11111111000011111111
23330333000033303332
23330333000033303332
2UUUU0000000000UUUU2
2RRRR0000000000LLLL2
2RRRR0000000000LLLL2
2RRRR0000000000LLLL2
2RRRR0000000000LLLL2
2UUUUUUUUUUUUUUUUUU2
2UUUUUUUUUUUUUUUUUU2
2UUUUUUUUUUUUUUUUUU2
2UUUUUUUUUUUUUUUUUU2
22222222222222222222
33303330333303330333